4 4 4 4 2 2 2 2 3 3 3 3
 4 4 4 2 2 2 2 3 3 3 3
6 6 6 -1 6 6 6 6 -1 6 6 6
 4 2 3 -1 4 2 3 -1 4 2 3
6 6 6 6 -1 6 6 -1 6 6 6 6
